24x7	24 HOURS 7 DAYS A WEEK
AAMOF	AS A MATTER OF FACT
ADN	ANY DAY NOW
AFAICS	AS FAR AS I CAN SEE
AFAIK	AS FAR AS I KNOW
AFK	AWAY FROM KEYBOARD
AKA	ALSO KNOWN AS
ASAP	AS SOON AS POSSIBLE
ASL	AGE, SEX, LOCATION
ATM	AT THE MOMENT
AYT	ARE YOU THERE
B4	BEFORE
B4N	BYE FOR NOW
BBIAB	BE BACK IN A BIT
BBL	BE BACK LATER
BBS	BE BACK SHORTLY
BRB	BE RIGHT BACK
BF	BOYFRIEND
BIO	BIOGRAPHY
BOT	BACK ON TOPIC
BTDT	BEEN THERE DONE THAT
BTW	BY THE WAY
CRB	COME RIGHT BACK
CTC	CARE TO CHAT
CYA	SEE YA
DIN	DO IT NOW
DIY	DO IT YOURSELF
EOD	END OF DISCUSSION
F2F	FACE TO FACE
FWIW	FOR WHAT IT'S WORTH
FYI	FOR YOUR INFORMATION
G2G	GOT TO GO
GTG	GOT TO GO
GF	GIRLFRIEND
GG	GOOD GAME
GJ	GOOD JOB
GM	GOOD MORNING
H&K	HUGS AND KISSES
HAK	HUGS AND KISSES
HTH	HOPE THAT HELPS
IAC	IN ANY CASE
IC	I SEE
IMO	IN MY OPINION
IMHO	IN MY HUMBLEOPINION
IOW	IN OTHER WORDS
J/K	JUST KIDDING
Kewl	COOL
L8R	LATTER
LJBF	LETS JUST BE FRIENDS
LMAO	LAUGH MY A** OFF
LOL	LAUGH OUT LOUD
LTNS	LONG TIME NO SEE
MORF	MALE OR FEMALE
MOTD	MESSAGE OF THE DAY
MSG	MESSAGE
MYOB	MIND YOUR OWN BUSINESS
N1	NICE ONE
NM	NEVER MIND
NP	NO PROBLEM
NRN	NO RESPONSE NECESSARY
OIC	OH I SEE
OMG	OHH MY GOSH
OOTO	OUT OF THE OFFICE
OTOH	ON THE OTHER HAND
PAW	PARENTS ARE WATCHING
PLZ	PLEASE
RL	REAL LIFE
ROFL	ROLLING ON THE FLOOR LAUGHING
ROFLAPMP	ROLLING ON THE FLOOR LAUGHING AND PEEING MY PANTS
ROFLMAO	ROLLING ON THE FLOOR LAUGHING MY ASS OFF
ROFLMAOAY	ROLLING ON THE FLOOR LAUGHING MY ASS OFF AT YOU
ROFLMAOWTIME	ROLLING ON THE FLOOR LAUGHING MY ASS OFF WITH TEARS IN MY EYES
RU	ARE YOU
STFU	SHUT THE F*** UP
TANSTAAFL	THERE AINT NO SUCH THING AS A FREE LUNCH
THX	THANKS
TTFN	TA TA FOR NOW
TTYL	TALK TO YOU LATER
TY	THANK YOU
TYT	TAKE YOUR TIME
TYVM	THANK YOU VERY MUCH
W/	WITH
WB	WRITE BACK
WE	WHATEVER
WTF	WHAT THE F*** 
WTG	WAY TO GO
WUF	WHERE ARE YOU FROM
YW	YOU'RE WELCOME